5
6
WWWWW
WFFWW
WPCFW
WWFFW
WTFFW
WWWWW
