5
5
WWWWW
WPFFW
WFCFW
WFFTW
WWWWW