10
10
WWWWWWWWWW
WFFFFPFFFW
WFFFFFFFFW
WFFFFCFFFW
WFFFFFFFFW
WFFCFFFFFW
WFFFFFFFFW
WFFFFFFFFW
WFTFFFFTFW
WWWWWWWWWW